Number of iterations until convergence: 4
familia = family
muy = very
su = his
bananas = bananas
ropa = clothing
jugar = play
ellos = they
perro = dog
alto = high
en = room
amigo = friend
abajo = up
beso = kiss
juega = plays
gente = people
nuevo = new
divertido = fun
frutas = fruits
comida = food
chico = small
ella = up
sabe = tomato
blanca = white
fútbol = soccer
manzanas = apples
tomate = tomato
lugar = place
grande = big
deporte = sport
comer = eat
tres = three
él = he
libro = book
genial = awesome
rico = tomato
auto = car
salta = jumps
es = is
rápido = fast
balón = for
con = time
ese = that
tiempo = time
podridas = rotten
compramos = bought
leer = read
amo = love
azúl = blue
yo = I
gracioso = funny
cocinar = cook
comí = ate
mi = my
di = gave
este = this
dulces = sweet
fijar = weather
de = from
son = are
color = favorite
pasar = time
largo = long
nosotros = bought
rojo = red
saludables = healthy
uvas = grapes
te = you
verduras = vegetables
tengo = have
lejos = far
corre = runs
niño = child
el = the
cerca = close
arriba = up
y = and
manejar = drive
un = a
graciosos = funny
agua = pretty
linda = pretty
favorito = favorite
cuarto = room
casa = house
va = goes
mejor = best
nieve = snow
clima = weather
